XXXXXXX
XPVVVVX
XXXXXVX
XVVVVVX
XVXXXXX
XVVVVGX
XXXXXXX